100 40
0000000000000900000000000000000000000000000000000000000000000000000000000000000000000000000000000000
0000000000000100000000000000000000000000000000000000000000000000000000000000000000000000000000000000
0000000000000100000000000000000000000000000000001111111111111111111111111111111111111111111111111111
0000000000000100000000000000000000000000000000001000010000000000000000000000000000000000000000000001
0000000000000111111111111111111111111111111111111010010000000000000000000000000000000000000000000001
0000000000000100000000000000000010000000000000000010010000000000000000000000000000000000000000000001
0000000000000100000000000000000010000000000000000010010000000000000000000000000000000000000000000001
0000000000000100000000000000000010000000000000000010011111111111111118000000000000000000000000000001
0000000000000100000000000000000010000000000000000010000000000000000001000000000000000000000000000001
0000000000000100000000000000000111100000000000000011111111111111111111000000000000000000000000000001
0000000000000100000000000000000111100000000000000010000000000000000001000000000000000000000000000001
0000000000000100000000000000000031000000000000000010000000000000000001000000000000000000000000000001
0000000000000100000000000000000000000000000000000010000000000000000001000000000000000000000000000001
0000000000000100000000000000000000000000000000000011111111111111111111111111000000000000000000000001
0000000000000100000000000000000000000000000000000010000000000000001000000001000000000000000000000001
0000011100000100000000000000000000000000000000000010000000000000001000000001000000000000000000000001
0000013111111111111111111111111111111111111111111110000000111111111000000001000000000000000000000001
0000011100000010000000000000000000100000000000000010000000100000000000000001000000000000000000000001
0000000100000010000000000000000000100000000000000011100000100000000000000001111111111111111111111111
0000000100000010000000000000000000100000000000000051100000100000000000000001000000000000001000000000
0000000100000010000000000000000000000000000000000000111111111111111111111111000000000000001000000000
0000000100000011111111111111111111100000000000000000100000000000000000001000000000000000001000000000
0000000100000000000000000000000000100000000000000000100000000000000000001000000000000000001000000000
0000000100000000000000000000000000100000000000000000100000000000000000000000000000000000001000000000
0000000100000000000000000000000000100000000000000000100011111111111111111111111111111111111000000000
0000000100000000000000000000000000100000000000000000100000000000100000000000000000000000001000000000
0000000111111111111111111111111111111111111111111111100000000000100000000000001000000000001000000000
0000000000000100000000000000000000000000000000000000100000000000100000000000001000000000001000000000
0000000000000100000000000000000000000000000000000000100000000000100000000000001000000000001000000000
0000000000000100000000000000000000000000000000000000100000000000100000000000001000000000001000000000
0000000000000100000000000000000000000000000000000000100000000000100000000000001000000000001000000000
0000000000000100000000000000000000000000000000000000100000000000100000000000001111111111101000000000
0000000000000100000000000000000000000000000000000000100000000000100000000000000000000000001000000000
0000000000000100000000000000000000000000000000000000100000000000100000000000000000000000001000000000
0000000000000100000000000000000000000000000000000001110000000000100000000000000000000000001000000000
0000000000000100000000000000000000000000000000000001111111111111111111111111111111111111111000000000
0000000000000100000000000000000000000000000000000001310000000000100000000000000000000000000000000000
0000000000000100000000000000000000000000000000000000000000000000100000000000000000000000000000000000
0000000000000100000000000000000000000000000000000000000000000000100000000000000000000000000000000000
0000000000000900000000000000000000000000000000000000000000000000900000000000000000000000000000000000
